F 220,100,0
C 225,30,0

NO textures/north2.xpm

EA textures/east2.xpm

SO textures/south2.xpm

WE textures/west2.xpm

     111
     101
     101
     1011111111
     1N00000001
     1011111111
     101
     101
111111011111
100000000001
111111111111
