F 220,100,0
C 225,30,0

NO textures/north2.xpm

EA textures/east2.xpm

SO textures/south2.xpm

WE textures/west2.xpm

11111111111111
10000000000001
10000000E10101
10000000000001
111111111111110000