F 220,100,0
C 225,30,0

NO textures/north.xpm

EA textures/east.xpm

SO textures/south.xpm




WE textures/west.xpm



11111111111111        11111
10000000000001        10001
100000000W0001        10001
10000000000001        10001
11111111111111        11111