F 220,100,0
C 225,30,0

NO textures/north.xpm

EA textures/east.xpm

SO textures/south.xpm

WE textures/west.xpm

11111111111111      1111111111111111111111111      1111111111111111111111111      1111111111111111111111111      1111111111111111111111111      1111111111111111111111111      11111111111
10000000000001      1000000000110000000000001      1000000000110000000000001      1000000000110000000000001      1000000000110000000000001      1000000000110000000000001      10000000001
100000000S0001      1000000000110000000000001      1000000000110000000000001      1000000000110000000000001      1000000000110000000000001      1000000000000000000000001      10000000001
100000000000011111111000011100110000000000001111111100001110011000000000000111111110000111001100000000000011111111000011100000000000000001111111100001110011000000000000111111110000111001
11111111011100000000000001 100111111111011100000000000001 100111111111011100000000000001 100111111111011100000000000001 100111111111011100000000000001 100111111111011100000000000001 1001
111111111111111111101111011100111111111111111111111111101110011111111111111111111111110111001111111111111111111111111011100111111111111111111111111101110011111111111111111111111110111001
111111111111111111101111000000111111111111111111111111100000011111111111111111111111110000001111111111111111111111111000000111111111111111111111111100000011111111111111111111111110000001
111111111111111111100111111111111111111111111111111111111111111111111111111111111111111111111111111111111111111111111111110111111111111111111111111111111111111111111111111111111110111111
11111111011100000000000001 100111111111011100000000000001 100111111111011100000000000001 100111111111011100000000000001 100111111111011100000000000001 100111111111011100000000000001 1001
111111111111111111100111011100111111111111111111111111101110011111111111111111111111110111001111111111111111111111111011100111111111111111111111111101110011111111111111111111111110111001
111111111111111111101111000000111111111111111111111111100000011111111111111111111111110000001111111111111111111111111000000111111111111111111111111100000011111111111111111111111110000001
111111111111111111100111111111111111111111111111111111111111111111111111111111111111111111111111111111111111111111111111101111111111111111111111111111111111111111111111111111111110111111
11111111011100000000000001 100111111111011100000000000001 100111111111011100000000000001 100111111111011100000000000001 100000000000000000000000000001 100111111111011100000000000001 1001
111111111111111111111011011100111111111111111111111111101110011111111111111111111111110111001111111111111111111111111011100111111111111111111111111101110011111111111111111111111110111001
111111111111111111111000000000111111111111111111111111100000011111111111111111111111110000001111111111111111111111111000000111111111111111111111111100000000000000000000000000000000000001
111111111111111111111101111111111111111111111111111111111111111111111111111111111111111111111111111111111111111111111111101111111111111111111111111111111111111111111111111111111111111111
11111111011100000000000001 100111111111011100000000000001 100111111111011100000000000001 100111111111011100000000000001 100111111111011100000000000001 100111111111011100000000000001 1001
111111111111111111111101011100111111111111111111111111101110011111111111111111111111110111001111111111111111111111111011100111111111111111111111111101110011111111111111111111111110111001
11111111011100000000000001 100111111111011100000000000001 100111111111011100000000000001 100111111111011100000000000001 100111111111011100000000000001 100111111111011100000000000001 1001
111111111111111111111101011100111111111111111111111111101110011111111111111111111111110111001111111111111111111111111011100111111111111111111111111101110011111111111111111111111110111001
111111111111111111111100000000000000000000000000000000000000011111111111111111111111110000001111111111111111111111111000000111111111111111111111111100000011111111111111111111111110000001
111111111111111111111111111111111111111111111111011111111111111111111111111111111111111111111111111111111111111111111111101111111111111111111111111111111111111111111111111111111111111111
11111111011100000000000001 100111111111011100000000000001 100111111111011100000000000001 100111111111011100000000000001 100111111111011100000000000001 100111111111011100000000000001 1001
111111111111111111111111011100111111111111111110111111101110011111111111111111111111110111001111111111111111111111111011100111111111111111111111111101110011111111111111111111111110111001
111111111111111111111111000000111111111111111110111111100000011111111111111111111111110000001111111111111111111111111000000111111111111111111111111100000011111111111111111111111110000001
111111111111111111111111111111111111111111111110011111111111111111111111111111111111111111111111111111111111111111111011111111111111111111111111111111111111111111111111111111111111111111
11111111011100000000000001 10011111111101110000000000000111001111111110111000000000000011100111111111011100000000000001 100111111111011100000000000001 100111111111011100000000000001 1001
111111110111000000000011111111111111111011100000000000000000000000000000000000000000000000000000000000000000000000011111111111111111011100000000001111111111111111101110000000000111111111
111111111111111111111111111111111111111111111111111111111111111111111111111111110111111111111111111111111111111111111111111111111111111111111111111111111111111111111111111111111111111111
111111111111111111111111011100111111111111111111111111101110011111111111111111110001110111001111111111111111111111111011100111111111111111111111111101110011111111111111111111111110111001
11111111011100000000000001 100111111111011100000000000001 100111111111011100000000000001 100111111111011100000000000001 100111111111011100000000000001 100111111111011100000000000001 1001
111111111111111111111111011100111111111111111111111111101110011111111111111111111111110111001111111111111111111111111011100111111111111111111111111101110011111111111111111111111110111001
111111111111111111111111000000111111111111111111111111100000011111111111111111111111110000001111111111111111111111111000000111111111111111111111111100000011111111111111111111111110000001
111111111111111111111111111111111111111111111111111111111111111111111111111111111111111111111111111111111111111111111111111111111111111111111111111111111111111111111111111111111111111111
11111111011100000000000001 100111111111011100000000000001 100111111111011100000000000001 100111111111011100000000000001 100111111111011100000000000001 100111111111011100000000000001 1001
111111111111111111111111011100111111111111111111111111101110011111111111111111111111110111001111111111111111111111111011100111111111111111111111111101110011111111111111111111111110111001
11111111111111111111111100000011111111111111111111111110000001  1111111111111111111111110000001  1111111111111111111111110000001  1111111111111111111111110000001  11111111111111111111111 
111111111111111111111111111111111111111111111111111111111111111111111111111111111111111111111111111111111111111111111111111111111111111111111111111111111111111111111111111111111111111111
11111111011100000000000001 100111111111011100000000000001 100111111111011100000000000001 100111111111011100000000000001 100111111111011100000000000001 100111111111011100000000000001 1001
111111110111000000000011111111111111111011100000000001111111111111111101110000000000111111111111111110111000000000011111111111111111011100000000001111111111111111101110000000000111111111
111111111111111111111111111111111111111111111111111111111111111111111111111111111111111111111111111111111111111111111111111111111111111111111111111111111111111111111111111111111111111111
111111111111111111111111011100111111111111111111111111101110011111111111111111111111110111001111111111111111111111111011100111111111111111111111111101110011111111111111111111111110111001
11111111011100000000000001 100111111111011100000000000001 100111111111011100000000000001 100111111111011100000000000001 100111111111011100000000000001 100111111111011100000000000001 1001
111111111111111111111111011100111111111111111111111111101110011111111111111111111111110111001111111111111111111111111011100111111111111111111111111101110011111111111111111111111110111001
111111111111111111111111000000111111111111111111111111100000011111111111111111111111110000001111111111111111111111111000000111111111111111111111111100000011111111111111111111111110000001
111111111111111111111111111111111111111111111111111111111111111111111111111111111111111111111111111111111111111111111111111111111111111111111111111111111111111111111111111111111111111111
11111111011100000000000001 100111111111011100000000000001 100111111111011100000000000001 100111111111011100000000000001 100111111111011100000000000001 100111111111011100000000000001 1001
111111111111111111111111011100111111111111111111111111101110011111111111111111111111110111001111111111111111111111111011100111111111111111111111111101110011111111111111111111111110111001
111111111111111111111111000000111111111111111111111111100000011111111111111111111111110000001111111111111111111111111000000111111111111111111111111100000011111111111111111111111110000001
111111111111111111111111111111111111111111111111111111111111111111111111111111111111111111111111111111111111111111111111111111111111111111111111111111111111111111111111111111111111111111
11111111011100000000000001 100111111111011100000000000001 100111111111011100000000000001 100111111111011100000000000001 100111111111011100000000000001 100111111111011100000000000001 1001
111111110111000000000011111111111111111011100000000001111111111111111101110000000000111111111111111110111000000000011111111111111111011100000000001111111111111111101110000000000111111111
111111111111111111111111111111111111111111111111111111111111111111111111111111111111111111111111111111111111111111111111111111111111111111111111111111111111111111111111111111111111111111
11111111011100000000000001 100111111111011100000000000001 100111111111011100000000000001 100111111111011100000000000001 100111111111011100000000000001 100111111111011100000000000001 1001
111111111111111111111111011100111111111111111111111111101110011111111111111111111111110111001111111111111111111111111011100111111111111111111111111101110011111111111111111111111110111001
11111111111111111111111100000011111111111111111111111110000001  1111111111111111111111110000001  1111111111111111111111110000001  1111111111111111111111110000001  11111111111111111111111 
111111111111111111111111111111111111111111111111111111111111111111111111111111111111111111111111111111111111111111111111111111111111111111111111111111111111111111111111111111111111111111
11111111011100000000000001 100111111111011100000000000001 100111111111011100000000000001 100111111111011100000000000001 100111111111011100000000000001 100111111111011100000000000001 1001
111111110111000000000011111111111111111011100000000001111111111111111101110000000000111111111111111110111000000000011111111111111111011100000000001111111111111111101110000000000111111111
111111111111111111111111111111111111111111111111111111111111111111111111111111111111111111111111111111111111111111111111111111111111111111111111111111111111111111111111111111111111111111
111111111111111111111111011100111111111111111111111111101110011111111111111111111111110111001111111111111111111111111011100111111111111111111111111101110011111111111111111111111110111001
11111111011100000000000001 100111111111011100000000000001 100111111111011100000000000001 100111111111011100000000000001 100111111111011100000000000001 100111111111011100000000000001 1001
111111111111111111111111011100111111111111111111111111101110011111111111111111111111110111001111111111111111111111111011100111111111111111111111111101110011111111111111111111111110111001
111111111111111111111111000000111111111111111111111111100000011111111111111111111111110000001111111111111111111111111000000111111111111111111111111100000011111111111111111111111110000001
111111111111111111111111111111111111111111111111111111111111111111111111111111111111111111111111111111111111111111111111111111111111111111111111111111111111111111111111111111111111111111
11111111011100000000000001 100111111111011100000000000001 100111111111011100000000000001 100111111111011100000000000001 100111111111011100000000000001 100111111111011100000000000001 1001
111111111111111111111111011100111111111111111111111111101110011111111111111111111111110111001111111111111111111111111011100111111111111111111111111101110011111111111111111111111110111001
111111111111111111111111000000111111111111111111111111100000011111111111111111111111110000001111111111111111111111111000000111111111111111111111111100000011111111111111111111111110000001
111111111111111111111111111111111111111111111111111111111111111111111111111111111111111111111111111111111111111111111111111111111111111111111111111111111111111111111111111111111111111111
11111111011100000000000001 100111111111011100000000000001 100111111111011100000000000001 100111111111011100000000000001 100111111111011100000000000001 100111111111011100000000000001 1001
111111110111000000000011111111111111111011100000000001111111111111111101110000000000111111111111111110111000000000011111111111111111011100000000001111111111111111101110000000000111111111
111111111111111111111111111111111111111111111111111111111111111111111111111111111111111111111111111111111111111111111111111111111111111111111111111111111111111111111111111111111111111111
11111111011100000000000001 100111111111011100000000000001 100111111111011100000000000001 100111111111011100000000000001 100111111111011100000000000001 100111111111011100000000000001 1001
111111111111111111111111011100111111111111111111111111101110011111111111111111111111110111001111111111111111111111111011100111111111111111111111111101110011111111111111111111111110111001
11111111111111111111111100000011111111111111111111111110000001  1111111111111111111111110000001  1111111111111111111111110000001  1111111111111111111111110000001  11111111111111111111111 
111111111111111111111111111111111111111111111111111111111111111111111111111111111111111111111111111111111111111111111111111111111111111111111111111111111111111111111111111111111111111111
11111111011100000000000001 100111111111011100000000000001 100111111111011100000000000001 100111111111011100000000000001 100111111111011100000000000001 100111111111011100000000000001 1001
111111110111000000000011111111111111111011100000000001111111111111111101110000000000111111111111111110111000000000011111111111111111011100000000001111111111111111101110000000000111111111
111111111111111111111111111111111111111111111111111111111111111111111111111111111111111111111111111111111111111111111111111111111111111111111111111111111111111111111111111111111111111111
111111111111111111111111011100111111111111111111111111101110011111111111111111111111110111001111111111111111111111111011100111111111111111111111111101110011111111111111111111111110111001
11111111011100000000000001 100111111111011100000000000001 100111111111011100000000000001 100111111111011100000000000001 100111111111011100000000000001 100111111111011100000000000001 1001
111111111111111111111111011100111111111111111111111111101110011111111111111111111111110111001111111111111111111111111011100111111111111111111111111101110011111111111111111111111110111001
111111111111111111111111000000111111111111111111111111100000011111111111111111111111110000001111111111111111111111111000000111111111111111111111111100000011111111111111111111111110000001
111111111111111111111111111111111111111111111111111111111111111111111111111111111111111111111111111111111111111111111111111111111111111111111111111111111111111111111111111111111111111111
11111111011100000000000001 100111111111011100000000000001 100111111111011100000000000001 100111111111011100000000000001 100111111111011100000000000001 100111111111011100000000000001 1001
111111111111111111111111011100111111111111111111111111101110011111111111111111111111110111001111111111111111111111111011100111111111111111111111111101110011111111111111111111111110111001
111111111111111111111111000000111111111111111111111111100000011111111111111111111111110000001111111111111111111111111000000111111111111111111111111100000011111111111111111111111110000001
111111111111111111111111111111111111111111111111111111111111111111111111111111111111111111111111111111111111111111111111111111111111111111111111111111111111111111111111111111111111111111
11111111011100000000000001 100111111111011100000000000001 100111111111011100000000000001 100111111111011100000000000001 100111111111011100000000000001 100111111111011100000000000001 1001
111111110111000000000011111111111111111011100000000001111111111111111101110000000000111111111111111110111000000000011111111111111111011100000000001111111111111111101110000000000111111111
111111111111111111111111111111111111111111111111111111111111111111111111111111111111111111111111111111111111111111111111111111111111111111111111111111111111111111111111111111111111111111
11111111011100000000000001 100111111111011100000000000001 100111111111011100000000000001 100111111111011100000000000001 100111111111011100000000000001 100111111111011100000000000001 1001
111111111111111111111111011100111111111111111111111111101110011111111111111111111111110111001111111111111111111111111011100111111111111111111111111101110011111111111111111111111110111001
11111111111111111111111100000011111111111111111111111110000001  1111111111111111111111110000001  1111111111111111111111110000001  1111111111111111111111110000001  11111111111111111111111 
111111111111111111111111111111111111111111111111111111111111111111111111111111111111111111111111111111111111111111111111111111111111111111111111111111111111111111111111111111111111111111
11111111011100000000000001 100111111111011100000000000001 100111111111011100000000000001 100111111111011100000000000001 100111111111011100000000000001 100111111111011100000000000001 1001
111111110111000000000011111111111111111011100000000001111111111111111101110000000000111111111111111110111000000000011111111111111111011100000000001111111111111111101110000000000111111111
111111111111111111111111111111111111111111111111111111111111111111111111111111111111111111111111111111111111111111111111111111111111111111111111111111111111111111111111111111111111111111
111111111111111111111111011100111111111111111111111111101110011111111111111111111111110111001111111111111111111111111011100111111111111111111111111101110011111111111111111111111110111001
11111111011100000000000001 100111111111011100000000000001 100111111111011100000000000001 100111111111011100000000000001 100111111111011100000000000001 100111111111011100000000000001 1001
111111111111111111111111011100111111111111111111111111101110011111111111111111111111110111001111111111111111111111111011100111111111111111111111111101110011111111111111111111111110111001
111111111111111111111111000000111111111111111111111111100000011111111111111111111111110000001111111111111111111111111000000111111111111111111111111100000011111111111111111111111110000001
111111111111111111111111111111111111111111111111111111111111111111111111111111111111111111111111111111111111111111111111111111111111111111111111111111111111111111111111111111111111111111
11111111011100000000000001 100111111111011100000000000001 100111111111011100000000000001 100111111111011100000000000001 100111111111011100000000000001 100111111111011100000000000001 1001
111111111111111111111111011100111111111111111111111111101110011111111111111111111111110111001111111111111111111111111011100111111111111111111111111101110011111111111111111111111110111001
111111111111111111111111000000111111111111111111111111100000011111111111111111111111110000001111111111111111111111111000000111111111111111111111111100000011111111111111111111111110000001
111111111111111111111111111111111111111111111111111111111111111111111111111111111111111111111111111111111111111111111111111111111111111111111111111111111111111111111111111111111111111111
11111111011100000000000001 100111111111011100000000000001 100111111111011100000000000001 100111111111011100000000000001 100111111111011100000000000001 100111111111011100000000000001 1001
111111110111000000000011111111111111111011100000000001111111111111111101110000000000111111111111111110111000000000011111111111111111011100000000001111111111111111101110000000000111111111
111111111111111111111111111111111111111111111111111111111111111111111111111111111111111111111111111111111111111111111111111111111111111111111111111111111111111111111111111111111111111111
11111111011100000000000001 100111111111011100000000000001 100111111111011100000000000001 100111111111011100000000000001 100111111111011100000000000001 100111111111011100000000000001 1001
111111111111111111111111011100111111111111111111111111101110011111111111111111111111110111001111111111111111111111111011100111111111111111111111111101110011111111111111111111111110111001
11111111111111111111111100000011111111111111111111111110000001  1111111111111111111111110000001  1111111111111111111111110000001  1111111111111111111111110000001  11111111111111111111111  
111111111111111111111111111111111111111111111111111111111111111111111111111111111111111111111111111111111111111111111111111111111111111111111111111111111111111111111111111111111111111111
11111111011100000000000001 100111111111011100000000000001 100111111111011100000000000001 100111111111011100000000000001 100111111111011100000000000001 100111111111011100000000000001 1001
111111110111000000000011111111111111111011100000000001111111111111111101110000000000111111111111111110111000000000011111111111111111011100000000001111111111111111101110000000000111111111
111111111111111111111111111111111111111111111111111111111111111111111111111111111111111111111111111111111111111111111111111111111111111111111111111111111111111111111111111111111111111111
111111111111111111111111011100111111111111111111111111101110011111111111111111111111110111001111111111111111111111111011100111111111111111111111111101110011111111111111111111111110111001
11111111011100000000000001 100111111111011100000000000001 100111111111011100000000000001 100111111111011100000000000001 100111111111011100000000000001 100111111111011100000000000001 1001
111111111111111111111111011100111111111111111111111111101110011111111111111111111111110111001111111111111111111111111011100111111111111111111111111101110011111111111111111111111110111001
111111111111111111111111000000111111111111111111111111100000011111111111111111111111110000001111111111111111111111111000000111111111111111111111111100000011111111111111111111111110000001
111111111111111111111111111111111111111111111111111111111111111111111111111111111111111111111111111111111111111111111111111111111111111111111111111111111111111111111111111111111111111111
11111111011100000000000001 100111111111011100000000000001 100111111111011100000000000001 100111111111011100000000000001 100111111111011100000000000001 100111111111011100000000000001 1001
111111111111111111111111011100111111111111111111111111101110011111111111111111111111110111001111111111111111111111111011100111111111111111111111111101110011111111111111111111111110111001
111111111111111111111111000000111111111111111111111111100000011111111111111111111111110000001111111111111111111111111000000111111111111111111111111100000011111111111111111111111110000001
111111111111111111111111111111111111111111111111111111111111111111111111111111111111111111111111111111111111111111111111111111111111111111111111111111111111111111111111111111111111111111
11111111011100000000000001 100111111111011100000000000001 100111111111011100000000000001 100111111111011100000000000001 100111111111011100000000000001 100111111111011100000000000001 1001
111111110111000000000011111111111111111011100000000001111111111111111101110000000000111111111111111110111000000000011111111111111111011100000000001111111111111111101110000000000111111111
111111111111111111111111111111111111111111111111111111111111111111111111111111111111111111111111111111111111111111111111111111111111111111111111111111111111111111111111111111111111111111
11111111011100000000000001 100111111111011100000000000001 100111111111011100000000000001 100111111111011100000000000001 100111111111011100000000000001 100111111111011100000000000001 1001
111111111111111111111111011100111111111111111111111111101110011111111111111111111111110111001111111111111111111111111011100111111111111111111111111101110011111111111111111111111110111001
11111111111111111111111100000011111111111111111111111110000001  1111111111111111111111110000001  1111111111111111111111110000001  1111111111111111111111110000001  11111111111111111111111  
111111111111111111111111111111111111111111111111111111111111111111111111111111111111111111111111111111111111111111111111111111111111111111111111111111111111111111111111111111111111111111
11111111011100000000000001 100111111111011100000000000001 100111111111011100000000000001 100111111111011100000000000001 100111111111011100000000000001 100111111111011100000000000001 1001
111111110111000000000011111111111111111011100000000001111111111111111101110000000000111111111111111110111000000000011111111111111111011100000000001111111111111111101110000000000111111111
111111111111111111111111111111111111111111111111111111111111111111111111111111111111111111111111111111111111111111111111111111111111111111111111111111111111111111111111111111111111111111
111111111111111111111111011100111111111111111111111111101110011111111111111111111111110111001111111111111111111111111011100111111111111111111111111101110011111111111111111111111110111001
11111111011100000000000001 100111111111011100000000000001 100111111111011100000000000001 100111111111011100000000000001 100111111111011100000000000001 100111111111011100000000000001 1001
111111111111111111111111011100111111111111111111111111101110011111111111111111111111110111001111111111111111111111111011100111111111111111111111111101110011111111111111111111111110111001
111111111111111111111111000000111111111111111111111111100000011111111111111111111111110000001111111111111111111111111000000111111111111111111111111100000011111111111111111111111110000001
111111111111111111111111111111111111111111111111111111111111111111111111111111111111111111111111111111111111111111111111111111111111111111111111111111111111111111111111111111111111111111
11111111011100000000000001 100111111111011100000000000001 100111111111011100000000000001 100111111111011100000000000001 100111111111011100000000000001 100111111111011100000000000001 1001
111111111111111111111111011100111111111111111111111111101110011111111111111111111111110111001111111111111111111111111011100111111111111111111111111101110011111111111111111111111110111001
111111111111111111111111000000111111111111111111111111100000011111111111111111111111110000001111111111111111111111111000000111111111111111111111111100000011111111111111111111111110000001
111111111111111111111111111111111111111111111111111111111111111111111111111111111111111111111111111111111111111111111111111111111111111111111111111111111111111111111111111111111111111111
11111111011100000000000001 100111111111011100000000000001 100111111111011100000000000001 100111111111011100000000000001 100111111111011100000000000001 100111111111011100000000000001 1001
111111110111000000000011111111111111111011100000000001111111111111111101110000000000111111111111111110111000000000011111111111111111011100000000001111111111111111101110000000000111111111
111111111111111111111111111111111111111111111111111111111111111111111111111111111111111111111111111111111111111111111111111111111111111111111111111111111111111111111111111111111111111111