F 200,200,200
C 128,128,128

NO textures/north.xpm

EA textures/east.xpm

SO textures/south.xpm

WE textures/west.xpm

11111111111111      11111111111
10000000000001      10000000001
10000000S00001      10000000001
1000000000000111111110000111001
11111111011100000000000001 1001
1111111111111111111111110111001
1111111111111111111111110000001
1111111111111111111111111111111