F 220,100,0
C 225,30,0

NO textures/north.xpm

EA textures/east.xpm

SO textures/east.xpm

WE textures/west.xpm

11111111111111      11111111111
10000000000001      10000000001
100000000S0001      10000000001
1000000000000111111110000111001
11111111011100000000000001 1001
1111111111111111111111110111001
1111111111111111111111110000001  
1111111111111111111111111111111