F 220,100,7
C 265,0,0

NO textures/north.xpm

EA textures/east.xpm

SO textures/south.xpm

WE textures/west.xpm

        1111111111111111111111111
        1000000000110000000000001
        1011000001110000000000001
        1001000000000000000000001
111111111011000001110000000000001
100000000011000001110111111111111
11110111111111011100000010001    
11110111111111011010100000001
11000000110101011100000010001
10000000001111000110000001001
10000000001 100000011010100W1
11000001111111111111101111001
11110111 1110101 101111010001
11111111 1111111 111111111111