F 0,250,  0
C 225,  30,0

NO textures/north.xpm         

EA textures/east.xpm

SO textures/south.xpm

WE textures/west.xpm

1111111111111111111111111111111111111111111111111111111111111111111111
10000000W0000001000000000000000000000000000000000000000000000000000001
1000000000000001111111111111111111101111111111111111111111111111101111
1000000000000001                  101                           101111
1111111011111111                  101                           100001
1111111011111111                  101                           110001
1111110011                        101                            1001
    110011                        101                            101 
    110011                        101                            101
    110111                        1011111111111111111111111111111001
    110011                        1000000000000000000000000000000001
    100001                        111111111110111111101111111111111
11111100111111111111111111111111111111111111100000000011111111111111
1000000000000000000000000000000000000000000000000000011
1111111111111111111111111111111111111111111111111111111
